0000000000
0 O    O 0
0 . OO   0
0 O O    0
0 OOOO O.0
0 O O    U
0 OOOOOO.0
0 O      0
0 O OOOOO0
0 . O    0
0000000000 