OOOOOOOOOOOOOOOOOOOOOOOOOOOOOOOOOOOOOOOOOOOOOOOOOOOOOOOOOOOOOOOOOOO
OX OOOOOOOOOOOOOOOOOOOOOOOOO          . .          . O .        . O
O  OOO                    OOOOOOOOOOOOO.OOOOOOOOOOOO   OOOOOOOOOO O
O O  . OOOOOOO.OOOOOOOOOO           OOO OOOOOOO OOOOOOOOOOOOOOOOO O
O OOOO .    OO O   OOOOOOOOOOOOOOOO          OO OOOOOO          O.O
O OOOOOOOOOOOO OO           OOOOOOOOOOOOOOOO         . OOOOOOOO.O O
O              OOOOOOOOOOO            OOOOOOOOOOOOOOOOOOOOOOOOO O.O
OOOO OOO OOO O          OOOOOOOOOOOO               OOOO .  . OO O O
OO O O O O O OOOOOOOOOO          OOOOOOOOOOOO OOOO      OOOO OO O O
OO.OOO.OOO.OO           OOOOOOOO            O O OOOOOOO    O OO O O
O             OOOOOOOOOO        OOOOOOOOOOOOO O OOOOOOOOOO O OO O O
O.OOOOOOOOOOOOOOO         OOOO              O O OOOOOOO OO O    O O
O O             O.OOOOOOOOOOOOOOO OOOO OOOOOO O OOO   O OO O.OOOO O
O O.OOOOOOOO.OOOO.OOOOOOOOOOOOOOO OOOO O    . O O   OOO OO O OO O O
O O       OO                    O OOOO O.OOOO O OOO   O OO O OO O O
O.OOOOOOOOOOOOOOOOOOOOOOOOOOOOO O OOOO O      O O   OOO OO O OO O O
O                            OO O OOOO O OOOOOO.OOO.OOO OO O OO O O
O O.OOOOOOOO O O O O O O O O  O O O    O O            O OO O OO O O
O O O O O O OOOOOOOOOOOOOOOOOOO O O OOOO O OOOOOOOOOO.O OO O OO O O
O O O                         . O O OOOO O OOOO   . O O OO O OO O O
O O O.OOOOOOOOOOOOOOOOOOOOOOOOO O O    O O O    OOO O O OO O OO OOO
O.OOO OO OO OO OO OO OO       . O OOOO O O OOOO.OOOOO O OO O OO OOO
O  OO                   OOOOOOO O OOOO O O      O   O O OO O OO OOO
OO.OO.OOOOOOOOOOOOOOOOOOO     O O OOOO O O OOOOOO.O O.O OO.OOOO OOO
OO OO              OOOOOOOOOO O O      O O        O O O OO        O
OO.OOOOOOOOOOOOOOOOO .        . O.OOOOOO.OOOOOOOOOO.OOO.OOOOOOOOOOO
OO                 . OOOOOOOOOOOO      O          O               U
OOOOOOOOOOOOOOOOOOOOOOOOOOOOOOOOOOOOOOOOOOOOOOOOOOOOOOOOOOOOOOOOOOO